00000000000000000000000000000000000000000000000000000000000000000000000000000000000000000000000000000000000000000000000000000000
00000000000000000000000000000000000000000000000000000000000000000000000000000000000000000000000000000000000000000000000000000000
00000000000000000000000000000000000000000000000000000000000000000000000000000000000000000000000000000000000000000000000000000000
00000000000000000000000000000000000000000000000000000000000000000000000000000000000000000000000000000000000000000000000000000000
00000000000000000000000000000000000000000000000000000000000000000000000000000000000000000000000000000000000000000000000000000000
00000000000000000000000000000000000000000000000000000000000000000000000000000000000000000000000000000000000000000000000000000000
00000000000000000000000000000001111111111011111111111111100000000000111000000000000000000000000001111000000000000000000000000000
00000000000000000000001110001110111010000111111111111111100000000000011010000000000000000000000000001110000000000000000000000000
00000000000000000001111100101111000000000000111111111111100000000000000000000000000111000000011111111111100000000000000000000000
10000000111000000000001111100110111110111100011111111111000000000000000000000000000100001101111111111111111111111111110000000000
11000111111111111111110000100011011111111110011111111100000000000000001111111100001111111101111111111111111111111111111111111111
11100111111111111111001111111111111011111110011111110000111100000000111101110111111111111011111111111111111111111111111111111111
00000001111111111111111111111111001100011000001111000000111000000011110011111111111111111111111111111111111111111111111111111111
00000111111111111111111011111110000011100100000110000000000000000011110011101111111111111111111111111111111111111111111001111000
00000001110000011111111111111111000011111100000000000000000000100000110011111111111111111111111111111111111111111100000011100000
00000010000000001111111111111111110011111111000000000000000011010001100111111111111111111111111111111101111111111000000111000000
00000000000000000111111111111111111111111111100000000000000010110111111111111111111111111111111111111011111111111110000110000000
00000000000000000011111111111111111111111101100000000000000000001111111111111111111111111111111111111111111111111110000000000000
00000000000000000000111111111111010111111111010000000000000000011111111111101011000110111111111111111111111111111010100000000000
00000000000000000000111111111111101011111000000000000000000001111111101111000011101111111111111111111111111111110011000000000000
00000000000000000000111111111111111111100000000000000000000001111001010111111111100111111111111111111111111111000010000000000000
00000000000000000000111111111111111110000000000000000000000001110000000111111111110111111111111111111111110001000110000000000000
00000000000000000000011111111111111110000000000000000000000000001111000000000111111111111111111111111111111001011100000000000000
00000000000000000000001111111111111100000000000000000000000001111111110110001111111111111111111111111111111000110000000000000000
00000000000000000000001111111111001100000000000000000000000011111111111111111111101111111111111111111111111000000000000000000000
00000000000000000000000111111000000100000000000000000000000111111111111111110111110101111111111111111111111000000000000000000000
00000000000000000000000011111000000100000000000000000000001111111111111111111011111110001111111111111111110100000000000000000000
00000000000000000000000000111100110011000000000000000000001111111111111111111011111110000011111001111100000000000000000000000000
00000000000000000000000000011111100000110000000000000000001111111111111111111101111100000011110001111101000100000000000000000000
00000000000000000000000000000011111000000000000000000000001111111111111111111101110000000011100000111110000100000000000000000000
00000000000000000000000000000000110000010000000000000000001111111111101111111110000000000011100000011110000110000000000000000000
00000000000000000000000000000000001001111100000000000000000111111111111111111111111000000001100000010100000010000000000000000000
00000000000000000000000000000000000011111110000000000000000011111111111111111111110000000000100000010000000010000000000000000000
00000000000000000000000000000000000011111111110000000000000000000011111111111111100000000000000000101000110000000000000000000000
00000000000000000000000000000000000111111111110000000000000000000001111111111111000000000000000000011001110110000000000000000000
00000000000000000000000000000000000111111111111110000000000000000001111111101110000000000000000000011001111100010100000000000000
00000000000000000000000000000000000111111111111111000000000000000000111111111100000000000000000000001100001101011111011000000000
00000000000000000000000000000000000111111111111111110000000000000000111111011100000000000000000000000011000000000111100100000000
00000000000000000000000000000000000011111111111111100000000000000000011111110100000000000000000000000000000110000000110010000000
00000000000000000000000000000000000011111111111111000000000000000000111111110110010000000000000000000000000000110010000000000000
00000000000000000000000000000000000001111111111111000000000000000000111111111100110000000000000000000000000011111011000000000000
00000000000000000000000000000000000000111111111111000000000000000000111111111000110000000000000000000000000111111111000000000000
00000000000000000000000000000000000000011111111111000000000000000000011111111001110000000000000000000000011111111111100000000000
00000000000000000000000000000000000000011111111110000000000000000000011111111001100000000000000000000000111111111111110000000000
00000000000000000000000000000000000000111111111000000000000000000000011111110000000000000000000000000000111111111111111000000000
00000000000000000000000000000000000000111111111000000000000000000000001111100000000000000000000000000000111111111111111000000000
00000000000000000000000000000000000000111111110000000000000000000000001111000000000000000000000000000000011110011111110000000000
00000000000000000000000000000000000000111111100000000000000000000000000000000000000000000000000000000000000000000111110000000000
00000000000000000000000000000000000000111111000000000000000000000000000000000000000000000000000000000000000000000000000000000010
00000000000000000000000000000000000000111111000000000000000000000000000000000000000000000000000000000000000000000001100000000110
00000000000000000000000000000000000001111000000000000000000000000000000000000000000000000000000000000000000000000000100000011100
00000000000000000000000000000000000001110000000000000000000000000000000000000000000000000000000000000000000000000000000000011000
00000000000000000000000000000000000001111000000000000000000000000000000000000000000000000000000000000000000000000000000000000000
00000000000000000000000000000000000001110001000000000000000000000000000000000000000000000000000000000000000000000000000000000000
00000000000000000000000000000000000000111000000000000000000000000000000000000000000000000000000000000000000000000000000000000000
00000000000000000000000000000000000000000000000000000000000000000000000000000000000000000000000000000000000000000000000000000000
00000000000000000000000000000000000000000000000000000000000000000000000000000000000000000000000000000000000000000000000000000000
00000000000000000000000000000000000000000000000000000000000000000000000000000000000000000000000000000000000000000000000000000000
00000000000000000000000000000000000000000000000000000000000000000000000000000000000000000000000000000000000000000000000000000000
00000000000000000000000000000000000000000000000000000000000000000000000000000000000000000000000000000000000000000000000000000000
00000000000000000000000000000000000000000000000000000000000000000000000000000000000000000000000000000000000000000000000000000000
00000000000000000000000000000000000000000000000000000000000000000000000000000000000000000000000000000000000000000000000000000000
00000000000000000000000000000000000000000000000000000000000000000000000000000000000000000000000000000000000000000000000000000000
00000000000000000000000000000000000000000000000000000000000000000000000000000000000000000000000000000000000000000000000000000000